222222222222222222222
200011010110111010002
202120212020202121202
201001000010101000102
202121212120202120212
211010010000100100102
212021202120202021212
201010101011000100012
202121212021202121202
200101010100100110012
202120202021202021202
210010110100100111012
212120212021212120212
210101010000101010102
202021212120212121212
210100100010111001002
212120202120202120202
201101001001101011012
202020212021202120202
200100101000110100002
222222222222222222222