222222222222222222222
200000000000000000002
202020202020202020202
200000000000000000002
202020202020202020202
200000000000000000002
202020202020202020202
200000000000000000002
202020202020202020202
200000000000000000002
202020202020202020202
200000000000000000002
202020202020202020202
200000000000000000002
202020202020202020202
200000000000000000002
202020202020202020202
200000000000000000002
202020202020202020202
200000000000000000002
222222222222222222222