222222222222222222222
200010011000101101002
202120202121212120202
210110001010001010102
212021202021212121202
200100111001001000102
212121202120202120212
201011010010010011002
212020202021202120212
200110000100111001012
212021212020202021202
201010100011000100102
212120202120212121202
201100111000100011012
212021212021212120202
210010010010110011012
202121202121202120202
211010110010100010112
202020212121202121202
200100101010110011002
222222222222222222222