222222222222222222222
200000000000000000002
202111202110212010202
200100101001011110002
202111201021212010202
200100101001010010002
202111202110212010202
200000000000000000002
202111201111011120202
200100101000010010002
202111101112011120202
200100101000010100002
202111201111010010202
200000000000000000002
202120102110212010202
200111101001010010002
202120101111211010202
200100101001010110002
202120101021212010202
200000000000000000002
222222222222222222222