222222222222222222222
200010011000101101002
202020202021212120202
201010101001000010102
202021202021202121202
211100001111001000102
202121202121202120212
201111000111010011112
212120202021212120212
200110000100111011112
212021212020202020202
201010100011000100102
212120202120212121202
201000111000000011012
212020212020212120202
210110010011110000002
212121202120202020202
211100110111100010102
202020212021202121202
200100101010110100002
222222222222222222222