222222222222222222222
200011010110111110002
202120212020212121202
201001000010101000102
202121212120202120212
211010010000100100102
212021202120202021212
200001101011000000002
202121212021202120202
200111010100100110002
202121202021202021202
211110110100100111012
212120212021212120212
210101010000101010102
202121212120212121212
211100100010111001012
212120202120202120212
201111000001111011012
202020212021212120202
200100101000110100002
222222222222222222222