222222222222222222222
200110100001000100002
202120202120212020202
211000011010110110002
202121212021202120212
210011010010010110012
202020202121202120202
200110101010110010002
202020202120202121212
201101100110101110002
212020212021202020202
200011000010100011002
202020202120202120202
201000100011010101102
212121212121212120202
211100101100100010112
202120212120202120202
201000010001010101102
202020202020212120202
200010010010001000002
222222222222222222222
